╔════════════╗╔════════════╗
║∙∙∙∙∙∙∙∙∙∙∙∙║║∙∙∙∙∙∙∙∙∙∙∙∙║
║∙╔══╗∙╔═══╗∙║║∙╔═══╗∙╔══╗∙║
║∙║  ║∙║   ║∙║║∙║   ║∙║  ║∙║
║∙╚══╝∙╚═══╝∙╚╝∙╚═══╝∙╚══╝∙║
║∙∙∙∙∙∙∙∙∙∙∙∙∙∙∙∙∙∙∙∙∙∙∙∙∙∙║
║∙╔══╗∙╔╗∙╔══════╗∙╔╗∙╔══╗∙║
║∙╚══╝∙║║∙╚══╗╔══╝∙║║∙╚══╝∙║
║∙∙∙∙∙∙║║∙∙∙∙║║∙∙∙∙║║∙∙∙∙∙∙║
╚════╗∙║╚══╗∙║║∙╔══╝║∙╔════╝
     ║∙║╔══╝∙╚╝∙╚══╗║∙║     
     ║∙║║∙∙∙∙∙∙∙∙∙∙║║∙║     
     ║∙║║∙╔══  ══╗∙║║∙║     
═════╝∙╚╝∙║      ║∙╚╝∙╚═════
∙∙∙∙∙∙∙∙∙∙║      ║∙∙∙∙∙∙∙∙∙∙
═════╗∙╔╗∙║      ║∙╔╗∙╔═════
     ║∙║║∙╚══════╝∙║║∙║     
     ║∙║║∙∙∙∙∙∙∙∙∙∙║║∙║     
     ║∙║║∙╔══════╗∙║║∙║     
╔════╝∙╚╝∙╚══╗╔══╝∙╚╝∙╚════╗
║∙∙∙∙∙∙∙∙∙∙∙∙║║∙∙∙∙∙∙∙∙∙∙∙∙║
║∙╔══╗∙╔═══╗∙║║∙╔═══╗∙╔══╗∙║
║∙╚═╗║∙╚═══╝∙╚╝∙╚═══╝∙║╔═╝∙║
║∙∙∙║║∙∙∙∙∙∙∙∙∙∙∙∙∙∙∙∙║║∙∙∙║
╚═╗∙║║∙╔╗∙╔══════╗∙╔╗∙║║∙╔═╝
╔═╝∙╚╝∙║║∙╚══╗╔══╝∙║║∙╚╝∙╚═╗
║∙∙∙∙∙∙║║∙∙∙∙║║∙∙∙∙║║∙∙∙∙∙∙║
║∙╔════╝╚══╗∙║║∙╔══╝╚════╗∙║
║∙╚════════╝∙╚╝∙╚════════╝∙║
║∙∙∙∙∙∙∙∙∙∙∙∙∙∙∙∙∙∙∙∙∙∙∙∙∙∙║
╚══════════════════════════╝